Ngân hàng An Bình - ABBank
Ngân hàng Á Châu - ACB
Ngân hàng NN & PTNT VN - Agribank
Ngân hàng ANZ Việt Nam - ANZ
BANGKOK  BANK - BANGKOK  BANK
Công ty cổ phần chuyển mạch tài chính quốc gia Việt Nam - Banknetvn
Ngân hàng TMCP Bảo Việt - Baoviet Bank
BANK OF CHINA - BC
NH ĐT&PT Campuchia CN HCM - BIDC HCM
NH ĐT&PT Campuchia CN Hà Nội - BIDC HN
Ngân hàng Đầu tư và Phát triển Việt Nam - BIDV
BNP Paribas Bank HCM - BNP Paribas HCM
Ngan hang BNP Paribas CN Ha Noi - BNP Paribas HN
Bank of Communications - BOC
Ngân hàng BPCEIOM CN  TP Hồ Chí Minh - BPCEICOM
BANK OF TOKYO - MITSUBISHI UFJ - TP HCM - BTMU HCM
BANK OF TOKYO - MITSUBISHI UFJ - HN - BTMU HN
Credit Agricole Corporate and Investment Bank - CACIB
Commonwealth Bank of Australia - CBA
China Construction Bank Corporation - CCBC
The Chase Manhattan Bank - CHASE
Ngân hàng TNHH MTV CIMB Việt Nam - CIMB
Citi Bank TP HCM - CitibankHCM
Citi Bank Ha Noi - CitibankHN
Ngân hàng Hợp tác Việt Nam - COOPBANK
Ngân hàng CTBC CN TP Hồ Chí Minh - CTBC
Ngân hàng Cathay - CTU
DEUTSCHE BANK - DB
DBS Bank Ltd - DBS
Ngân hàng Đông Á - Dong A Bank, DAB
Ngân hàng Xuất nhập khẩu Việt Nam - Eximbank
First Commercial Bank - FCNB
First Commercial Bank Ha Noi - FCNB HN
Ngân hàng Dầu khí Toàn cầu - GP Bank
Ngân hàng Phát triển TP HCM - HDBank
Ngân hàng Hong Leong Viet Nam - HLO
Hua Nan Commercial Bank - HNCB
NH TNHH Một Thành Viên HSBC Việt Nam - HSBC
Ngân hàng The Hongkong và Thượng Hải - HSBC HN
Industrial Bank of Korea - IBK
ICB of China CN Ha Noi - ICB
Indovina Bank - IVB
Kho Bạc Nhà Nước - KBNN
Korea Exchange Bank - KEB
Ngân hàng Kiên Long - Kienlongbank
Ngân hàng Kookmin - KMB
Ngan hàng TMCP Bưu điện Liên Việt - Lienvietbank,  LPB
Ngân hàng Hàng Hải Việt Nam - Maritime Bank, MSB
Malayan Banking Berhad - Maybank
Ngân hàng Quân Đội - MB
Malayan Banking Berhad - MBB
Mizuho Corporate Bank - TP HCM - MCB_HCM
Mega ICBC Bank - MICB
Mizuho Corporate Bank - Mizuho Bank
Ngân hàng Nam Á - Nam A Bank, NAB
Ngân hàng Bắc Á - NASBank, NASB
Ngân hàng Quoc Dan - NCB
Oversea - Chinese Bank - OCBC
Ngân hàng Đại Dương - Ocean Bank
Ngân hàng Phương Đông - Oricombank, OCB
Ngân hàng Xăng dầu Petrolimex - PG Bank
NH TMCP Đại Chúng Viet Nam - PVcombank
Quỹ tín dụng cơ sở - QTDCS
Ngân hàng Sài Gòn Thương Tín - Sacombank
Ngân hàng Sài Gòn Công Thương - Saigonbank
Ngân Hàng Nhà Nước - SBV
Ngân hàng TMCP Sài Gòn - SCB
Ngân hàng Standard Chartered Bank Việt Nam - SCBank
Ngân hàng Standard Chartered Bank HN - SCBank HN
The Shanghai Commercial & Savings Bank CN Đồng Nai - SCSB
Ngân hàng TMCP Đông Nam Á - SeABank
Ngân hàng Sài Gòn - Hà Nội - SHB
Ngân hàng TNHH MTV Shinhan Việt Nam - Shinhan Bank
Ngân hàng The Siam Commercial Public - SIAM
Sumitomo Mitsui Banking Corporation HCM - SMBC
Sumitomo Mitsui Banking Corporation HN - SMBC HN
Ngân hàng SinoPac - SPB
Ngân hàng Kỹ thương Việt Nam - Techcombank, TCB
Taipei Fubon Commercial Bank Ha Noi - TFCBHN
Taipei Fubon Commercial Bank TP Ho Chi Minh - TFCBTPHCM
United Oversea Bank - UOB
Ngân hàng Chính sách xã hội Việt Nam - VBSP
Ngân hàng Phát triển Việt Nam - VDB
Ngân hàng Quốc tế - VIBank, VIB
Ngân hàng VID Public - VID public
Ngân hàng Việt Hoa - Viet Hoa Bank
Ngân hàng Việt Á - VietA Bank, VAB
Ngân hàng Việt Nam Thương Tín - Vietbank
NHTMCP Bản Việt - VietCapital Bank
Ngân hàng TMCP Ngoại Thương - Vietcombank
Ngân hàng công thương Việt Nam - Vietinbank
NH TMCP Xây dựng Việt Nam - VNCB
Ngân hàng Thương mại cổ phần Việt Nam Thịnh Vượng - VPBank
Ngân hàng Liên doanh Việt Nga - VRB
Ngân hàng Vũng Tàu - Vung Tau
NH Woori HCM - WHHCM
WOORI BANK Hà Nội - WHHN
